#########################################
#.....#.......#...#...#...........#.....#
#.#.###.#####.#.#.#.#.#.#####.###.#.#.#.#
#.#.....#...#.#.#...#.......#.#...#.#.#.#
#.#######.###.#.#############.#.#####.#.#
#...#.....#...#.......#.......#.......#.#
###.###.###.#########.#.###############.#
#0#.....#...#...#.....#...#.#.........#.#
#.#####.#.###.#.#.#######.#.#.#####.###.#
#.#.....#...#.#.........#.#.#.#...#.#...#
#.#.#####.#.#.#####.#####.#.#.#.#.#.#.###
#...#...#.#...#...#.#.....#.#.#.#.#.#.#.#
#.###.#.#######.#.###.#####.#.#.#.#.#.#.#
#.#...#.........#...#.#.......#.#.#.#.#.#
###.## ############.#.#.#######.#.#.#.#.#
#...#.................#.#.#.....#...#.#.#
#.###.#################.#.#.#########.#.#
#...#.#.............#.....#.#.........#.#
###.###.###########.## ####.#.#########.#
#...#...#.......# #...#...#.#.....#.....#
#.###.###.#####.#.###.#.#.#.#####.#.###.#
#.#...#...#...#...#.#S#.#.#.#.....#.#.#.#
#.#.#####.#.#.###.#.?##.#.#.#.#####.#.#.#
#.#.#.....#.#.#...#...#.#.#.#.#.....#...#
#.#.###.###.#.#.###.#.#.#.#.#.#####.#.###
#.#.#...#.#.#...#...#...#.#.#.....#.#...#
#.#.#.###.#.#####.## ####.#.#####.#.###.#
#...#.#...#.#.....#.......#.....#...#...#
#####.#.###.#.#####.###########.#####.###
#.....#...#.#.#.....................#...#
#.###.#.#.#.#.#######.#####.#######.###.#
#.#...#.#...#.......#.#...#.#...#.....#.#
#.#.###.#########.#.#.#.#.###.#.#.#####.#
#.#.#...........#.#.#.#.#.....#.#.#.....#
###.###########.###.###.#######.###.#####
#...#.....#...#.....#...#.#.....#...#...#
#.###.###.#.#.#####.#.###.#.###.#.###.#.#
#.....#...#.#.#...#.#.....#.#...#...#.#.#
#.#####.###.#.#.#.#######.#.#######.###.#
#.....#.....#...#.........#.............#
#########################################